S+++###########
###+###########
##++##T+++#####
##+###+##++++##
##+###+#####+##
##+++++##++++##
#########E#####
######++++#####
######+########
######E+++++###
#+E+#######+###
#+#+++++T+++###
#+#############
#+++E++++T++++G
