##########
###+++####
###S#+####
#####+####
#####++###
######+E+#
########+#
#++++++++#
#G########
