S+++###########
###+###########
##++##++++#####
##+###+##++++##
##+###+#####+##
##+++++##++++##
#########+#####
######++++#####
######+########
######++++++###
#+++#######+###
#+#+++++++++###
#+#############
#+++++++++++++G
