#####################
##T+++++#############
#######+#############
#####+++##E+++++++T##
#####+####+##########
#####+####+##########
#####+###++##########
#####+###T###########
#####++++S+++########
#########+##+########
#########+##++E++T###
#####+++++###########
#####+###+###########
#####E###+###########
#####+###+###########
#####+###++++++######
#####+########+######
##T+++########+######
##############+++E++#
###################G#
